++++++++++++++++++++++++++++++++++++++++++++++++++
+                                                +
+   +   +    +++++    +++++    +++++    +++++    +
+   +   +    +        +    g     +      +        +
+   +   +    +        +          +      +        +
+   +   +    +++++    +++++      +      +        +
+   +   +    +            +      +      +        +
+   +   +    +            +      +      +        +
+   +++++    +++++    +++++      +      +++++    +
+                                                +
+                                        g       +
+                                                +
+ g                                              +
+                                                +
+                                                +
+   +     +   +++++    +   +    +++++   +++++    +
+   ++    +     +      +   +    +         +      +
+   + +   +     +      +   +    +         +      +
+   +  +  +     +      +   +    +++++     +      +
+   +   + +     +      +   +        +     +      +
+   +    ++     +      +   +        +     +      +
+   +     +     +      +++++    +++++     +      +
+                     g                          +
+                                                +
++++++++++++++++++++++++++++++++++++++++++++++++++